XXXXXXXXXXXXXXXXXXXXXXXXXXXXXXXX
XooooooooooooooXXooooooooooooooX
XooooooooooooooXXooooooooooooooX
XooooooooooooooXXooooooooooooooX
X              XX           2  X
XooooooooooooooXXooooooooooooooX
XooooooooooooooXXooooooooooooooX
XooooooooooooooXXooooooooooooooX








XXXXXXXXXXXXX       XXXXXXXXXXXX
XXXXXXXXXXXXX       XXXXXXXXXXXX


X              XX              X
X              XX              X
X              XX              X
X              XX              X
X              XX              X
X              XX              X
X              XX              X
X              XX              X
X              XX              X
X              XX              X
X              XX              X
X  1           XX              X
XXXXXXXXXXXXXXXXXXXXXXXXXXXXXXXX
