XXXXXXXXXXXXXXXXXXXXXXXXXXXXXXXX
X              XX              X
X              XX              X
X              XX              X
X              XX           2  X
X              XX              X
X              XX              X
X              XX              X
X              XX              X
X              XX              X
X              XX              X
X              XX              X
X              XX              X
X              XX              X
X         o               o    X
XXXXXXXXXXXXX       XXXXXXXXXXXX
XXXXXXXXXXXXX       XXXXXXXXXXXX
X                              X
X              XX              X
X              XX              X
X              XX              X
X              XX              X
X              XX              X
X              XX              X
X              XX              X
X              XX              X
X              XX              X
X              XX              X
X              XX              X
X              XX              X
X  1           XX              X
XXXXXXXXXXXXXXXXXXXXXXXXXXXXXXXX
