XXXXXXXXXXXXXXXXXXXXXXXXXXXXXXXX
X              XX              X
X              XX              X
X              XX              X
X              XX              X
X              XX              X
X              XX              X
X              XX              X
X              XX              X
X              XX              X
X              XX              X
X              XX              X
X              XX              X
X              XX              X
X                         o    X
XXXXXXXXXXXXX       XXXXXXXXXXXX
XXXXXXXXXXXXX       XXXXXXXXXXXX
X                              X
X              XX              X
X              XX              X
X              XX              X
X              XX              X
X              XX              X
X              XX              X
X              XX              X
X              XX              X
X              XX              X
X              XX              X
X              XX              X
X              XX              X
X              XX              X
XXXXXXXXXXXXXXXXXXXXXXXXXXXXXXXX
